.###...........
..##...#...###.
.#...##...#....
..##...#.#.....
...#.@.#.....#.
...#####.##..#.
#.#............
..##.##...#.###
#.#....#.......
#.#.......#.##.
#....#.....#.##
...#....#..#...
.#....##...#.#.
.#.###.......#.
...###....#..#.