...
...
.....@
.#..###.#..
.#..#.#.#..
.#..#.#.#..
.#..#.#.#..
.##.###.##.
..
..
..
